





NO 						/Users/faata/Desktop/cub3d/textures/epic.xpm
SO							/Users/faata/Desktop/cub3d/textures/Icon2.xpm
WE /Users/faata/Desktop/cub3d/textures/Icon6.xpm
EA /Users/faata/Desktop/cub3d/textures/Icon10.xpm
F 50,50,										50
C 160,	32,	255

	1111111111111111111111111
		10111000000000000000111111
11111111111110000000000001101
		1000000000000S01111111
1111111111110000000000011111
			10000000000000001111111
1111111111111111111111111111
