
NO ./textures/epic.xpm
SO ./textures/Icon2.xpm
EA ./textures/Icon10.xpm
WE ./textures/Icon6.xpm

F 50,50,50
C 135,206,235

	1111111111111111111111111
			10000000000000001
11111111111110111111111111101
		10000000000000S1111111
11111111111100000000000111111111
			1111110000000000000001111111
11111111111111111111111111111111
