





NO 						/Users/faata/Desktop/cub3d/textures/epic.xpm
SO							/Users/faata/Desktop/cub3d/textures/Icon2.xpm
WE /Users/faata/Desktop/cub3d/textures/Icon6.xpm
EA a
EA /Users/faata/Desktop/cub3d/textures/Icon10.xpm
F 50,50,										50
C 160,	32,	240

1111111111111111111111111
1000000000000000000000001
1000000000000000000000001101
10000000000000N000000000001
1000000000000000000000011111
100000000000000000000001
111111111111111111111111111