





NO 						/Users/faata/Desktop/cub3d/textures/epic.xpm
SO							/Users/faata/Desktop/cub3d/textures/Icon2.xpm
WE /Users/faata/Desktop/cub3d/textures/Icon6.xpm
EA /Users/faata/Desktop/cub3d/textures/Icon10.xpm
F 0,0,255
C 255,0,0

	1111111111111111111111111
			10000000000000001
11111111111110111111111111101
		1000000000000S01111111
11111111111100000000000111111111
			111110000000000000001111111
11111111111111111111111111111111
