
C 255,0,0
NO                                     /Users/faata/Desktop/cub3d/textures/epic.xpm
SO							/Users/faata/Desktop/cub3d/textures/Icon2.xpm
WE /Users/faata/Desktop/cub3d/textures/Icon6.xpm
F 0,0,255
EA /Users/faata/Desktop/cub3d/textures/Icon10.xpm


	111111111111111111111111
			10000000000000001
11111111111110111111111111101
		10000000000000S1111111
111111111111000000000001111111111111
			111110000000000000000111111
111111111111111111111111111111111111